***....****...+++...
.............+++++..
....****....***.....
...........++++++...
..****....++++......
.***................
........++++++++++..
....****............
...............+++..
..********..........
......*****.........
......****...++++...
....******....+++...
........+++++++++++.