+++....*******.....*
.....++++..........*
***....****........*
++++++...........*.*
....++++..****.....*
........***........*
++++++++++.........*
..........****.....*
+++................*
........********...*
.......*****.......*
.++++...****.......*
.+++....******.....*
......*****.........