***....****...++++++
.............+++++..
....****....***.....
...........++++++...
..****....++++......
.***................
........+++++++++++.
....****............
...............++++.
..********..........
......*****.........
......****...++++...
....******....+++...
...*******.......++.  