....*******....+++..
.............+++++..
***....****.........
++++++...........*..
....++++..****......
........***.........
++++++++++..........
..........****......
+++.................
........********....
.......*****........
.++++...****........
.+++....******......
....******....+++...