+++***....****......
.....++++...........
***....****.........
++++++..............
....++++..****......
........***.........
++++++++++..........
..........****......
+++.................
........********....
.......*****........
.++++...****........
.+++....******......
...*******.......++.